=====....
=X..=....
=.BB=.===
=.B.=.=O=
===.===O=
.==....O=
.=...=..=
.=...====
.=====...