.====.
==..=.
=XB.=.
==B.==
==.B.=
=OB..=
=OOVO=
======