.======.
.=X.===.
.=.B..==
===.=..=
=O=.=..=
=OB..=.=
=O...B.=
========