...=======...
====.....=...
=...O===.=...
=.=.=....==..
=.=.B.B=O.=..
=.=..V..=.=..
=.O=B.B.=.=..
==....=.=.===
.=.===O....X=
.=.....==...=
.============